# # # # # # # # # # # #
# . . . . . . . . . . #
S . # . # # # # . # . #
# # # . # . . . . # . #
# . . . . # # # . # . #
# # # # . # F # . # . #
# . . # . # . # . # . #
# # . # . # . # . # . #
# . . . . . . . . # . #
# # # # # # # # # # . #
# . . . . . . . . . . #
# # # # # # # # # # # #